####    ####
#        O #
#  P   #####
           #######
######            #
#O ##             #
#  ##      ######O#
#          #    ###
# XX    XX #
#       #  #
####  ######
