###################
#                 #
# ### # ### # ### #
#     #     #     #
# ### # ### # ### #
# #             # #
# # # ####### # # #
#   # ####### #   #
#  ## ####### ##  #
#     #######     #
#  ## ####### ##  #
#   # ####### #   #
# # # ####### # # #
# #             # #
# ### # ### # ### #
#     #     #     #
# ### # ### # ### #
#                 #
###################