###################
#                 #
# ### # ### # ### #
#     #     #     #
# ### # ### # ### #
# #             # #
# # #         # # #
#   #         #   #
#  ##         ##  #
#                 #
#  ##         ##  #
#   #         #   #
# # #         # # #
# #             # #
# ### # ### # ### #
#     #     #     #
# ### # ### # ### #
#                 #
###################