###################
#        P        #
# ### # ### # ### #
#     #     #     #
# ### # ### # ### #
# #             # #
# # # ####### # # #
#   # #     # #   #
#  ## #     # ##  #
#     #     #     #
#  ## #     # ##  #
#   # #     # #   #
# # # ####### # # #
# #             # #
# ### # ### # ### #
#     #     #     #
# ### # ### # ### #
#                 #
###################